11 11
.o........G
....o..o..G
..........G
S.........G
.....o.o..G
.o........G
..o....o..G
..........G
.....o....G
.o........G
.......o..G
