7 8
.o.....G
.....o.G
..oo...G
S.....oG
.......G
o..o...G
..o....G
