10 10
..........G
.....o....G
..........G
S.........G
........o.G
..........G
..o.......G
..........G
......o...G
..........G
