15 15
.o........o...G
....o.........G
......o.......G
S.............G
.....o......o.G
..............G
............o.G
...o..........G
.......o......G
.o............G
..............G
......o.......G
...o........o.G
..............G
..o.......o...G